0 0 0 0 0 0 0 0 0 0 0 0 0 0 0 0 0 0 0 0 0 0 0 0 0 0 0 0 0 0 0 0 0 0 0 0
0 0 0 0 0 0 0 0 0 0 0 0 0 0 0 0 0 0 0 0 0 0 0 0 0 0 0 0 0 0 0 0 0 0 0 0
0 0 0 0 0 0 0 0 0 0 0 0 0 0 0 0 0 0 0 0 0 0 0 0 0 0 0 0 0 0 0 0 0 0 0 0
0 0 0 0 0 0 0 0 0 0 0 0 0 0 0 0 0 0 0 0 0 0 0 0 0 0 0 0 0 0 0 0 0 0 0 0

0 0 0 0 0 7 7 7 0 7 7 7 0 7 7 7 7 7 7 7 7 7 7 7 7 0 4 4 4 0 0 0 0 0 0 0
0 0 0 0 0 7 7 7 0 7 0 7 0 7 0 0 0 0 0 0 0 0 7 7 7 0 4 4 4 0 0 0 0 0 0 0
0 0 0 0 0 7 7 7 0 7 0 7 0 7 7 7 7 7 7 7 7 7 7 7 7 0 4 4 4 0 0 0 0 0 0 0
0 0 0 0 0 7 7 7 7 7 0 7 0 7 0 0 0 0 0 0 0 0 7 7 7 7 0 3 0 3 0 0 0 0 0 0

0 0 0 0 0 0 0 0 7 7 0 7 7 4 4 4 4 4 4 4 4 4 4 7 7 7 7 7 7 7 0 0 0 0 0 0
0 0 0 0 0 7 7 7 7 7 0 7 0 4 4 4 4 4 4 4 4 4 4 0 7 7 7 7 7 7 0 0 0 0 0 0
0 0 0 0 0 7 0 0 0 0 7 7 0 4 4 4 4 4 4 4 4 4 4 0 7 0 0 7 0 0 0 0 0 0 0 0
0 0 0 0 0 7 7 7 7 0 7 7 0 4 4 4 4 4 4 4 4 4 4 0 7 0 0 7 0 0 0 0 0 0 0 0

0 0 0 0 0 7 0 0 0 0 7 7 0 4 4 4 4 4 4 4 4 4 4 0 7 0 0 7 0 0 0 0 0 0 0 0
0 0 0 0 0 7 7 7 7 0 7 7 0 4 4 4 4 4 4 4 4 4 4 0 7 0 0 7 0 0 0 0 0 0 0 0
0 0 0 0 0 7 0 0 0 0 7 7 0 4 4 4 4 4 4 4 4 4 4 0 7 7 7 7 7 7 0 0 0 0 0 0
0 0 0 0 0 7 7 7 7 7 7 7 7 4 4 4 4 4 4 4 4 4 4 7 7 7 0 7 0 7 0 0 0 0 0 0

0 0 0 0 0 7 0 0 0 0 7 7 7 7 0 0 0 0 0 0 0 0 7 7 0 0 0 7 0 0 0 0 0 0 0 0
0 0 0 0 0 7 7 7 7 0 0 7 7 7 7 7 7 7 7 7 7 7 7 7 0 0 0 7 0 0 0 0 0 0 0 0
0 0 0 0 0 7 7 7 7 0 0 0 0 0 0 0 0 0 0 0 0 0 7 0 0 0 0 7 7 0 0 0 0 0 0 0
0 0 0 0 0 7 7 7 7 7 7 7 7 7 7 7 7 7 7 7 7 7 7 7 7 7 7 7 7 0 0 0 0 0 0 0

0 0 0 0 0 0 0 0 0 0 0 0 0 0 0 0 0 0 0 0 0 0 0 0 0 0 0 0 0 0 0 0 0 0 0 0
0 0 0 0 0 0 0 0 0 0 0 0 0 0 0 0 0 0 0 0 0 0 0 0 0 0 0 0 0 0 0 0 0 0 0 0
0 0 0 0 0 0 0 0 0 0 0 0 0 0 0 0 0 0 0 0 0 0 0 0 0 0 0 0 0 0 0 0 0 0 0 0
0 0 0 0 0 0 0 0 0 0 0 0 0 0 0 0 0 0 0 0 0 0 0 0 0 0 0 0 0 0 0 0 0 0 0 0

0 0 0 0 0 0 0 0 0 0 0 0 0 0 0 0 0 0 0 0 0 0 0 0 0 0 0 0 0 0 0 0 0 0 0 0
